BACKWARD	B AE K W ER D
BROWSER	B R AW Z ER
E-MAIL	IY M EY L
EXIT	EH G Z IH T
EXIT(2)	EH K S AH T
FORWARD	F AO R W ER D
JOSEPH	JH OW S AH F
JOSEPH(2)	JH OW Z AH F
LAST	L AE S T
MAYBE	M EY B IY
MUSIC	M Y UW Z IH K
NEW	N UW
NEW(2)	N Y UW
NEXT	N EH K S T
NEXT(2)	N EH K S
NO	N OW
OPEN	OW P AH N
PLAYER	P L EY ER
WINDOW	W IH N D OW
YES	Y EH S
